Abigial - Quartz
Alex - Egg
Caroline - Tea Leaves
Clint - Iron Bar
Demitrius - Purple Mushroom
Dwarf - Cave Carrot
Elliott - Squid
Emily - Ruby
Evelyn - Tulip
George - Leek
Gus - Orange
Haley - Coconut
Harvey - Commun Mushroom
Jas - Dafodil
Jodi - Banana
Kent - Yam
Krobus - Gold Bar
Leah - Driftwood
Leo - Dragon tooth
Lewis - Blueberry
Linus - Holly
Marnie - Milk
Maru - Copper Bar
Pam - Cactus Fruit
Penny - Dandelion
Pierre - Summer Spangle
Robin - Hardwood
Sam - Joja Cola
Sandy - Goat Milk
Sebastian - Flounder
Shane - Hot Pepper
Vincent - Grape
Willy - Lingcod
Wizard - Void Essence